15 15
...............
.a.............
...............
...............
...#########...
...#.......#...
...#...?...#...
...#.......#...
...####A####===
...............
...............
...............
.......@.......
...............
...............
